#############B###############
#     #           #     #   #
### # ### ####### ##### ### #
#   # #   #     #     #     #
# ##### ### ### ### ### ### #
#   #   #   #   #   #   #   #
# ### ### ##### ### ### ### #
#         #     #   #     # #
### ####### ### ## ## ##### #
#   #   #   #       #   #   #
# ### # # ### ####### ### ###
#   # # #     #       #     #
### # ### ### #### ###### ###
#   #   #   # #       #     #
# ### ### ### # ### ##### ###
#       #   #   #   #   #   #
## #### ### ##### ### ### ###
#     #   #     # #     #   #
##### ##### ##### # ####### #
#   #       #     #     #   #
# ##### ### ##### ##### #####
#     #   #       #     #   #
### ########### ##### ##### #
#                 #       # #
# ####### # ##### ##### ### #
#       # # #   # #   #     #
####### ### ### ### ### #####
#                   #     # #
##### ######### ### ### ### #
#A         #     #          #
#############################